XXXXXXXXXX
X######TTX
XTTTTTTTTX
XTTTTTTTTX
XTTTTTTTTO
XXXXXXXXXX