XXXXXXXXXX
X###T####O
X###X####X
X###X###XX
X###X##XXX
XXXXXXXXXX