XXXXXXXXXX
X#####TTTX
XTTTTTTTTX
XTTTTTTTTX
XTTTTTTTTO
XXXXXXXXXX