XXXXXXXXXX
X####XXXXX
XXXX#XXXXX
XXXXSXXXXX
XXXXOXXXXX
XXXXTXXXXX